______________________________________________________________________________________________________
-                                                                                                    -
-                                                                                                    -
-                                                                                                    -                                                                     -
-                                                                                                    -
-                                                                                                    -
-                                                                                                    -
-                                                                                                    -
-                                                                                                    -
-                                                                                                    -
-                                                                                                    -
-                                                                                                    -
-                                                                                                    -
-                                                                                                    -
-                                                                                                    -
-                               B                                                                    -
-     --------      --------    -     -------           ---------           --------                 -
-                                                                                                  D -
-                                               K                                                    -
------------------------------------------------------------------------------------------------------