__________________________________
-                                -
-                       --       -
-                   -            -
-            --                  -
-                                -
--                  -            -
-                                -
-                   ----     --- -
-                                -
--             --                -
-         E                      -
-        --                  --- -
-            -                   -
-                                -
-      ---                       -
-             --                 -
-   -------         ----         -
--                               -
-              -          -   K  -
-                  --        --  -
-  -                  -          -
-                      -         -
----------------------------------