----------------------------------
-                                -
-                       --       -
-                                -
-            --                  -
-                                -
--                               -
-                                -
-                   ----     --- -
-                                -
--                               -
-                                -
-                            --- -
-                    E           -
-                                -
-      ---                       -
-                                -
-   -------         ----         -
-                                -
-                         -      -
-                            --  -
-                                -
-                                -
----------------------------------