__________________________________
-                                -
-                       --       -
-                                -
-            --                  -
-                                -
--                               -
-                                -
-                   ----     --- -
-                                -
--                               -
-                                -
-                            --- -
-                                -
-                                -
-      ---                       -
-   D                            -
-   -------         ----         -
--                               -
-                         -   K  -
-                            --  -
-  -                             -
-                      -         -
----------------------------------