__________________________________
-                                -
-                       --       -
-                   -            -
-            --                  -
-                                -
--                  -            -
-                                -
-                   ----     --- -
-                                -
--             --                -
-                                -
-        --                  --- -
-            -                   -
-                                -
-   D  ---                       -
-             --                 -
-   -------         ----         -
--                               -
-                         -   K  -
-                            --  -
-  -                             -
-                      -         -
----------------------------------