--------------------------------
-                              -
-                              -
-                              -
-                              -
-                              -
-                              -
-      -----                   -
-                              -
-              -----           -
----                           -
-                    K         -
-       ---        -----       -
-               E              -
-                              -
-               -----          -
-                              -
- D                            -
-                              -
--------------------------------