--------------------------------
-                              -
-                              -
-                              -
-                              -
-                              -
-                              -
-      -----     E             -
-  D                           -
-              -----           -
----                           -
-                              -
-       ---        -----       -
-               E              -
-                              -
-               -----          -
-                              -
-                              -
-                              -
--------------------------------